OOOO OOOO OOOO OOOO OOOO OOOO OOOO OOOO OOOO AAXA AEXA AAXA OOOO OOOO OOOO OOOO OOOO OOOO OOOO OOOO OOOO OOOO OOOO
OOOO AAAA AAAA AAAA AAAA AAAB AAAA AAAA AAAA AAAA AEAA AAAA AAAA AAAA AAAA AAAA AAAA AAAA AAAA AAAA AAAA AAAB OOOO
OOOO AAAA AAAA OOOO RCOC RCOC RCOC OOOO AAAA AAAA AEAA AAAA AAAA AAAA AAAA AAAA AAAA AAAA AAAA AAAA AAAB AAAA OOOO
OOOO AAAA AAAA OOOS AFBC AFBC AFBC OSOO AAAA AAAA AEAA AAAA AAAA AAAA AAAA AAAA AAAA AAAA AAAA AAAA AAAA AAAB OOOO
OOOO AAAA AAAA OOOS AFBC AFBC AFBC OSOO AAAA AAAA AEAA AAAA AAAA AAAA AAAA AAAA AAAA AAAA AAAA AAAA AAAA AAAA OOOO
OOOO AAAA AAAA OOOS AFBC AFBC AFBC OSOO AAAA AAAA AEAA AAAA AAAA AAAA AAAA AAAA AAAA AAAA AAAA AAAA AAAA AAAA OOOO
OOOO AAAA AAAA OOOB OCRC SOSO OCRC OOOO AAAA AAAA AEAA AAAA AAAA AAAA AAAA AAAA AAAA AAAA AAAA AAAA AAAA AAAA OOOO
OOOO AAAA AAAA AAAA AAAA AEAA AAAA AAAA AAAA AAAA AEAA AAAA AAAA AAAA AAAA AAAA AAAA AAAA AAAA AAAA AAAA AAAA OOOO
OOOO AAAA AAAA AAAA AAAA AEAA AAAA AAAA ACCE ACCA AECA ACCA ACCE AAAA AAAA AAAA AAAA AAAA AAAA AAAA AAAA AAAA OOOO
OOOO AAAA AAAA AAAA AAAA AEAA AAAA AAAA ACCA ALDD AFDA AMDD ACCA AAAA AAAA AAAA AAAA AAAA AAAA AAAA AAAA AAAA OOOO
AGAA AGAA AGAA AGAA AGAA AFAC AGAA AGAA AGCA AFDA AFDB AFDA AGCA AGAA AGAA AGAA AGAA AGAA AGAA AMAA AAAA AAAA AAAA
OOOO AAAA AAAA AAAA AAAA AEAA AAAA AAAA ACCA AODD AFDA ANDD ACCA AAAA AAAA AAAA AAAA AAAA AAAA AEAA AAAA AAAA OOOO
OOOO AAAA AAAA AAAA AAAA AEAA AAAA AAAA ACCE ACCA AECA ACCA ACCE AAAA AAAA AAAA AAAA AAAA AAAA AEAA AAAA AAAA OOOO
OOOO AAAA AAAA AAAA AAAA AEAA AAAA AAAA AAAA AAAA AEAA AAAA AAAA AAAA BBBB BBBB BBBB AAAA AAAA AEAA AAAA AAAA OOOO
OOOO AAAA AAAA AAAA AAAA AEAA AAAA AAAA AAAA AAAA AEAA AAAA AAAA AAAA BBBB AAAB SBBB AAAA AAAA AEAA AAAA AAAA OOOO
OOOO AAAA AAAA AAAA AAAA AEAA AAAA AAAA AAAA AAAA AEAA AAAA AAAA AAAA BBBB BBBB BBBB AAAA AAAA AEAA AAAA AAAA OOOO
OOOO AAAA AAAA AAAA AAAA AEAA AAAA AAAA AAAA AAAA AEAA AAAA AAAA AAAA AAAA AAAA AAAA AAAA AAAA AEAA AAAA AAAA OOOO
OOOO AAAA AAAA AAAA AAAA AEAA AAAA AAAA AAAA AAAA AEAA AAAA AAAA AAAA AAAA AAAA AAAA AAAA AAAA AEAA AAAA AAAA OOOO
OOOO AAAB AAAA AAAA AAAA AOAA AGAA AGAA AGAA AGAA AFAA AGAA AGAA AGAA AGAA AGAA AGAA AGAA AGAA ANAA AAAA AAAA OOOO
OOOO AAAA AAAB AAAA AAAA AAAA AAAA AAAA AAAA AAAA AEAA AAAA AAAA AAAA AAAA AAAA AAAA AAAA AAAA AAAA AAAA AAAA OOOO
OOOO AAAB AAAA AAAA AAAA AAAA AAAA AAAA AAAA AAAA AEAA AAAA AAAA AAAA AAAA AAAA AAAA AAAA AAAA AAAA AAAA AAAA OOOO
OOOO OOOO OOOO OOOO OOOO OOOO OOOO OOOO OOOO OOOO SSSS OOOO OOOO OOOO OOOO OOOO OOOO OOOO OOOO OOOO OOOO OOOO OOOO
AXXX AXXX AXXX AXXX AXXX AXXX AXXX AXXX AXXX AXXX AEAA AXXX AXXX AXXX AXXX AXXX AXXX AXXX AXXX AXXX AXXX AXXX AXXX
AXXX AXXX AXXX AXXX AXXX AXXX AXXX AXXX AXXX AXXX AEAA AXXX AXXX AXXX AXXX AXXX AXXX AXXX AXXX AXXX AXXX AXXX AXXX
AXXX AXXX AXXX AXXX AXXX OOOO OOOO OOOO OOOO OOOO AEAA OOOO OOOO AXXX OOOO OOOO AXXX AXXX AXXX AXXX AXXX AXXX AXXX
AXXX AXXX AXXX AXXX AXXX OOOO AAAA AAAA AAAA AAAA AEAA AAAA AAAA AAAA AAAA OOOO AXXX AXXX AXXX AXXX AXXX AXXX AXXX
AXXX AXXX AXXX AXXX AXXX OOOO AAAA AAAA AAAA AAAA AEAA AAAA AAAA AAAA AAAA OOOO AXXX AXXX AXXX AXXX AXXX AXXX AXXX
AXXX AXXX AXXX AXXX AXXX OOOO AAAA AAAA AAAA AAAA AEAA AAAA AAAA AAAA AAAA OOOO AXXX AXXX AXXX AXXX AXXX AXXX AXXX
AXXX AXXX AXXX AXXX AXXX OOOO AAAA AAAA AAAA AAAA AEAA AAAA AAAA AAAA AAAA OOOO AXXX AXXX AXXX AXXX AXXX AXXX AXXX
AXXX AXXX AXXX AXXX AXXX OOOO AAAA AAAA AAAA AAAA AEAA AAAA AAAA AAAA AAAA AAAA AXXX AXXX AXXX AXXX AXXX AXXC AXXX
AXXX AXXX AXXX AXXX AXXX OOOO OOOO OOOO OOOO OOOO AEAA OOOO OOOO OOOO OOOO OOOO AXXX AXXX AXXX AXXX AXXX AXXX AXXX