PPPP PPPP PPPP PPPP PPPP PPPP PPPP PPPP PPPP AAXA AEXA AAXA PPPP PPPP PPPP PPPP PPPP PPPP PPPP PPPP PPPP PPPP PPPP
PPPP AAAA AAAA AAAA AAAA AAAB AAAA AAAA AAAA AAAA AEAA AAAA AAAA AAAA AAAA AAAA AAAA AAAA AAAA AAAA AAAA AAAB PPPP
PPPP AAAA AAAA PPPP RCPC RCPC RCPC PPPP AAAA AAAA AEAA AAAA AAAA AAAA AAAA AAAA AAAA AAAA AAAA AAAA AAAB AAAA PPPP
PPPP AAAA AAAA PPPS AFBC AFBC AFBC PSPP AAAA AAAA AEAA AAAA AAAA AAAA AAAA AAAA AAAA AAAA AAAA AAAA AAAA AAAB PPPP
PPPP AAAA AAAA PPPS AFBC AFBC AFBC PSPP AAAA AAAA AEAA AAAA AAAA AAAA AAAA AAAA AAAA AAAA AAAA AAAA AAAA AAAA PPPP
PPPP AAAA AAAA PPPS AFBC AFBC AFBC PSPP AAAA AAAA AEAA AAAA AAAA AAAA AAAA AAAA AAAA AAAA AAAA AAAA AAAA AAAA PPPP
PPPP AAAA AAAA PPPB PCRC SPSP PCRC PPPP AAAA AAAA AEAA AAAA AAAA AAAA AAAA AAAA AAAA AAAA AAAA AAAA AAAA AAAA PPPP
PPPP AAAA AAAA AAAA AAAA AEAA AAAA AAAA AAAA AAAA AEAA AAAA AAAA AAAA AAAA AAAA AAAA AAAA AAAA AAAA AAAA AAAA PPPP
PPPP AAAA AAAA AAAA AAAA AEAA AAAA AAAA ACCE ACCA AECA ACCA ACCE AAAA AAAA AAAA AAAA AAAA AAAA AAAA AAAA AAAA PPPP
PPPP AAAA AAAA AAAA AAAA AEAA AAAA AAAA ACCA ALDD AFDA AMDD ACCA AAAA AAAA AAAA AAAA AAAA AAAA AAAA AAAA AAAA PPPP
AGAA AGAA AGAA AGAA AGAA AFAC AGAA AGAA AGCA AFDA AFDB AFDA AGCA AGAA AGAA AGAA AGAA AGAA AGAA AMAA AAAA AAAA AAAA
PPPP AAAA AAAA AAAA AAAA AEAA AAAA AAAA ACCA AODD AFDA ANDD ACCA AAAA AAAA AAAA AAAA AAAA AAAA AEAA AAAA AAAA PPPP
PPPP AAAA AAAA AAAA AAAA AEAA AAAA AAAA ACCE ACCA AECA ACCA ACCE AAAA AAAA AAAA AAAA AAAA AAAA AEAA AAAA AAAA PPPP
PPPP AAAA AAAA AAAA AAAA AEAA AAAA AAAA AAAA AAAA AEAA AAAA AAAA AAAA BBBB BBBB BBBB AAAA AAAA AEAA AAAA AAAA PPPP
PPPP AAAA AAAA AAAA AAAA AEAA AAAA AAAA AAAA AAAA AEAA AAAA AAAA AAAA BBBB AAAB SBBB AAAA AAAA AEAA AAAA AAAA PPPP
PPPP AAAA AAAA AAAA AAAA AEAA AAAA AAAA AAAA AAAA AEAA AAAA AAAA AAAA BBBB BBBB BBBB AAAA AAAA AEAA AAAA AAAA PPPP
PPPP AAAA AAAA AAAA AAAA AEAA AAAA AAAA AAAA AAAA AEAA AAAA AAAA AAAA AAAA AAAA AAAA AAAA AAAA AEAA AAAA AAAA PPPP
PPPP AAAA AAAA AAAA AAAA AEAA AAAA AAAA AAAA AAAA AEAA AAAA AAAA AAAA AAAA AAAA AAAA AAAA AAAA AEAA AAAA AAAA PPPP
PPPP AAAB AAAA AAAA AAAA AOAA AGAA AGAA AGAA AGAA AFAA AGAA AGAA AGAA AGAA AGAA AGAA AGAA AGAA ANAA AAAA AAAA PPPP
PPPP AAAA AAAB AAAA AAAA AAAA AAAA AAAA AAAA AAAA AEAA AAAA AAAA AAAA AAAA AAAA AAAA AAAA AAAA AAAA AAAA AAAA PPPP
PPPP AAAB AAAA AAAA AAAA AAAA AAAA AAAA AAAA AAAA AEAA AAAA AAAA AAAA AAAA AAAA AAAA AAAA AAAA AAAA AAAA AAAA PPPP
PPPP PPPP PPPP PPPP PPPP PPPP PPPP PPPP PPPP PPPP SSSS PPPP PPPP PPPP PPPP PPPP PPPP PPPP PPPP PPPP PPPP PPPP PPPP
AXXX AXXX AXXX AXXX AXXX AXXX AXXX AXXX AXXX AXXX AEAA AXXX AXXX AXXX AXXX AXXX AXXX AXXX AXXX AXXX AXXX AXXX AXXX
AXXX AXXX AXXX AXXX AXXX AXXX AXXX AXXX AXXX AXXX AEAA AXXX AXXX AXXX AXXX AXXX AXXX AXXX AXXX AXXX AXXX AXXX AXXX
AXXX AXXX AXXX AXXX AXXX PPPP PPPP PPPP PPPP PPPP AEAA PPPP PPPP AXXX PPPP PPPP AXXX AXXX AXXX AXXX AXXX AXXX AXXX
AXXX AXXX AXXX AXXX AXXX PPPP AAAA AAAA AAAA AAAA AEAA AAAA AAAA AAAA AAAA PPPP AXXX AXXX AXXX AXXX AXXX AXXX AXXX
AXXX AXXX AXXX AXXX AXXX PPPP AAAA AAAA AAAA AAAA AEAA AAAA AAAA AAAA AAAA PPPP AXXX AXXX AXXX AXXX AXXX AXXX AXXX
AXXX AXXX AXXX AXXX AXXX PPPP AAAA AAAA AAAA AAAA AEAA AAAA AAAA AAAA AAAA PPPP AXXX AXXX AXXX AXXX AXXX AXXX AXXX
AXXX AXXX AXXX AXXX AXXX PPPP AAAA AAAA AAAA AAAA AEAA AAAA AAAA AAAA AAAA PPPP AXXX AXXX AXXX AXXX AXXX AXXX AXXX
AXXX AXXX AXXX AXXX AXXX PPPP AAAA AAAA AAAA AAAA AEAA AAAA AAAA AAAA AAAA AAAA AXXX AXXX AXXX AXXX AXXX AXXC AXXX
AXXX AXXX AXXX AXXX AXXX PPPP PPPP PPPP PPPP PPPP AEAA PPPP PPPP PPPP PPPP PPPP AXXX AXXX AXXX AXXX AXXX AXXX AXXX