QQQQ QQQQ QQQQ QQQQ QQQQ QQQQ QQQQ QQQQ QQQQ AAXA AEXA AAXA QQQQ QQQQ QQQQ QQQQ QQQQ QQQQ QQQQ QQQQ QQQQ QQQQ QQQQ
QQQQ AAAA AAAA AAAA AAAA AAAB AAAA AAAA AAAA AAAA AEAA AAAA AAAA AAAA AAAA AAAA AAAA AAAA AAAA AAAA AAAA AAAB QQQQ
QQQQ AAAA AAAA QQQQ RCQC RCQC RCQC QQQQ AAAA AAAA AEAA AAAA AAAA AAAA AAAA AAAA AAAA AAAA AAAA AAAA AAAB AAAA QQQQ
QQQQ AAAA AAAA QQQS AFBC AFBC AFBC QSQQ AAAA AAAA AEAA AAAA AAAA AAAA AAAA AAAA AAAA AAAA AAAA AAAA AAAA AAAB QQQQ
QQQQ AAAA AAAA QQQS AFBC AFBC AFBC QSQQ AAAA AAAA AEAA AAAA AAAA AAAA AAAA AAAA AAAA AAAA AAAA AAAA AAAA AAAA QQQQ
QQQQ AAAA AAAA QQQS AFBC AFBC AFBC QSQQ AAAA AAAA AEAA AAAA AAAA AAAA AAAA AAAA AAAA AAAA AAAA AAAA AAAA AAAA QQQQ
QQQQ AAAA AAAA QQQB QCRC TQTQ QCRC QQQQ AAAA AAAA AEAA AAAA AAAA AAAA AAAA AAAA AAAA AAAA AAAA AAAA AAAA AAAA QQQQ
QQQQ AAAA AAAA AAAA AAAA AEAA AAAA AAAA AAAA AAAA AEAA AAAA AAAA AAAA AAAA AAAA AAAA AAAA AAAA AAAA AAAA AAAA QQQQ
QQQQ AAAA AAAA AAAA AAAA AEAA AAAA AAAA ACCE ACCA AECA ACCA ACCE AAAA AAAA AAAA AAAA AAAA AAAA AAAA AAAA AAAA QQQQ
QQQQ AAAA AAAA AAAA AAAA AEAA AAAA AAAA ACCA ALDD AFDA AMDD ACCA AAAA AAAA AAAA AAAA AAAA AAAA AAAA AAAA AAAA QQQQ
AGAA AGAA AGAA AGAA AGAA AFAC AGAA AGAA AGCA AFDA AFDB AFDA AGCA AGAA AGAA AGAA AGAA AGAA AGAA AMAA AAAA AAAA AAAA
QQQQ AAAA AAAA AAAA AAAA AEAA AAAA AAAA ACCA AODD AFDA ANDD ACCA AAAA AAAA AAAA AAAA AAAA AAAA AEAA AAAA AAAA QQQQ
QQQQ AAAA AAAA AAAA AAAA AEAA AAAA AAAA ACCE ACCA AECA ACCA ACCE AAAA AAAA AAAA AAAA AAAA AAAA AEAA AAAA AAAA QQQQ
QQQQ AAAA AAAA AAAA AAAA AEAA AAAA AAAA AAAA AAAA AEAA AAAA AAAA AAAA CCCC CCCC CCCC AAAA AAAA AEAA AAAA AAAA QQQQ
QQQQ AAAA AAAA AAAA AAAA AEAA AAAA AAAA AAAA AAAA AEAA AAAA AAAA AAAA CCCC AAAB TCCC AAAA AAAA AEAA AAAA AAAA QQQQ
QQQQ AAAA AAAA AAAA AAAA AEAA AAAA AAAA AAAA AAAA AEAA AAAA AAAA AAAA CCCC CCCC CCCC AAAA AAAA AEAA AAAA AAAA QQQQ
QQQQ AAAA AAAA AAAA AAAA AEAA AAAA AAAA AAAA AAAA AEAA AAAA AAAA AAAA AAAA AAAA AAAA AAAA AAAA AEAA AAAA AAAA QQQQ
QQQQ AAAA AAAA AAAA AAAA AEAA AAAA AAAA AAAA AAAA AEAA AAAA AAAA AAAA AAAA AAAA AAAA AAAA AAAA AEAA AAAA AAAA QQQQ
QQQQ AAAB AAAA AAAA AAAA AOAA AGAA AGAA AGAA AGAA AFAA AGAA AGAA AGAA AGAA AGAA AGAA AGAA AGAA ANAA AAAA AAAA QQQQ
QQQQ AAAA AAAB AAAA AAAA AAAA AAAA AAAA AAAA AAAA AEAA AAAA AAAA AAAA AAAA AAAA AAAA AAAA AAAA AAAA AAAA AAAA QQQQ
QQQQ AAAB AAAA AAAA AAAA AAAA AAAA AAAA AAAA AAAA AEAA AAAA AAAA AAAA AAAA AAAA AAAA AAAA AAAA AAAA AAAA AAAA QQQQ
QQQQ QQQQ QQQQ QQQQ QQQQ QQQQ QQQQ QQQQ QQQQ QQQQ TTTT QQQQ QQQQ QQQQ QQQQ QQQQ QQQQ QQQQ QQQQ QQQQ QQQQ QQQQ QQQQ
AXXX AXXX AXXX AXXX AXXX AXXX AXXX AXXX AXXX AXXX AEAA AXXX AXXX AXXX AXXX AXXX AXXX AXXX AXXX AXXX AXXX AXXX AXXX
AXXX AXXX AXXX AXXX AXXX AXXX AXXX AXXX AXXX AXXX AEAA AXXX AXXX AXXX AXXX AXXX AXXX AXXX AXXX AXXX AXXX AXXX AXXX
AXXX AXXX AXXX AXXX AXXX QQQQ QQQQ QQQQ QQQQ QQQQ AEAA QQQQ QQQQ AXXX QQQQ QQQQ AXXX AXXX AXXX AXXX AXXX AXXX AXXX
AXXX AXXX AXXX AXXX AXXX QQQQ AAAA AAAA AAAA AAAA AEAA AAAA AAAA AAAA AAAA QQQQ AXXX AXXX AXXX AXXX AXXX AXXX AXXX
AXXX AXXX AXXX AXXX AXXX QQQQ AAAA AAAA AAAA AAAA AEAA AAAA AAAA AAAA AAAA QQQQ AXXX AXXX AXXX AXXX AXXX AXXX AXXX
AXXX AXXX AXXX AXXX AXXX QQQQ AAAA AAAA AAAA AAAA AEAA AAAA AAAA AAAA AAAA QQQQ AXXX AXXX AXXX AXXX AXXX AXXX AXXX
AXXX AXXX AXXX AXXX AXXX QQQQ AAAA AAAA AAAA AAAA AEAA AAAA AAAA AAAA AAAA QQQQ AXXX AXXX AXXX AXXX AXXX AXXX AXXX
AXXX AXXX AXXX AXXX AXXX QQQQ AAAA AAAA AAAA AAAA AEAA AAAA AAAA AAAA AAAA AAAA AXXX AXXX AXXX AXXX AXXX AXXC AXXX
AXXX AXXX AXXX AXXX AXXX QQQQ QQQQ QQQQ QQQQ QQQQ AEAA QQQQ QQQQ QQQQ QQQQ QQQQ AXXX AXXX AXXX AXXX AXXX AXXX AXXX