AAAB AAAA AAAA BCDE BCDE BCDE BCDE BCDE BCDE BCDE BCDE BCDE BCDE BCDE BCDE BCDE BCDE BCDE BCDE BCDE BCDE BCDE BCDE BCDE BCDE BCDE BCDE BCDE BCDE BCDE BCDE
AAAA AAAA AAAA BCDE AAAA AAAA AAAA AAAA AAAA BCDE AAAA AAAA BCDE AAAA AAAA AAAA AAAA AAAA BCDE AAAA AAAA AAAA AAAA AAAA BCDE AAAA AAAA AAAA AAAA AAAA BCDE
BCDE AAAA AAAA BCDE BCDE BCDE BCDE AAAA AAAA BCDE AAAA AAAA BCDE BCDE BCDE BCDE AAAA AAAA BCDE AAAA AAAA BCDE BCDE BCDE BCDE AAAA AAAA BCDE AAAA AAAA BCDE
BCDE AAAA AAAA AAAA AAAA AAAA BCDE AAAA AAAA AAAA AAAA AAAA BCDE AAAA AAAA BCDE AAAA AAAA AAAA AAAA AAAA BCDE AAAA AAAA AAAA AAAA AAAA BCDE AAAA AAAA BCDE
BCDE AAAA AAAA BCDE BCDE BCDE BCDE BCDE BCDE BCDE AAAA AAAA BCDE AAAA AAAA BCDE AAAA AAAA BCDE AAAA AAAA BCDE AAAA AAAA BCDE BCDE BCDE BCDE AAAA AAAA BCDE
BCDE AAAA AAAA AAAA AAAA AAAA AAAA AAAA AAAA AAAA AAAA AAAA BCDE AAAA AAAA BCDE AAAA AAAA BCDE AAAA AAAA AAAA AAAA AAAA BCDE AAAA AAAA AAAA AAAA AAAA BCDE
BCDE AAAA AAAA BCDE BCDE BCDE BCDE BCDE BCDE BCDE BCDE BCDE BCDE AAAA AAAA BCDE BCDE BCDE BCDE BCDE BCDE BCDE BCDE BCDE BCDE AAAA AAAA BCDE AAAA AAAA BCDE
BCDE AAAA AAAA AAAA AAAA AAAA AAAA AAAA AAAA AAAA AAAA AAAA AAAA AAAA AAAA BCDE AAAA AAAA AAAA AAAA AAAA BCDE AAAA AAAA BCDE AAAA AAAA BCDE AAAA AAAA BCDE
BCDE AAAA AAAA BCDE BCDE BCDE BCDE AAAA AAAA BCDE BCDE BCDE BCDE AAAA AAAA BCDE AAAA AAAA BCDE BCDE BCDE BCDE AAAA AAAA BCDE AAAA AAAA BCDE BCDE BCDE BCDE
BCDE AAAA AAAA BCDE AAAA AAAA AAAA AAAA AAAA BCDE AAAA AAAA AAAA AFAA AFAA AFAA AAAA AAAA AAAA AAAA AAAA BCDE AAAA AAAA AAAA AAAA AAAA AAAA AAAA AAAA BCDE
BCDE AAAA AAAA BCDE BCDE BCDE BCDE BCDE BCDE BCDE BCDE BCDE BCDE AFAA AFAA AFAA BCDE BCDE BCDE AAAA AAAA BCDE AAAA AAAA BCDE BCDE BCDE BCDE AAAA AAAA BCDE
BCDE AAAA AAAA BCDE AAAA AAAA BCDE AAAA AAAA AAAA AAAA AAAA AAAA AFAA AFAA AFAA AAAA AAAA BCDE AAAA AAAA AAAA AAAA AAAA AAAA AAAA AAAA BCDE AAAA AAAA BCDE
BCDE BCDE BCDE BCDE AAAA AAAA BCDE BCDE BCDE BCDE AAAA AAAA BCDE BCDE BCDE BCDE AAAA AAAA BCDE BCDE BCDE BCDE BCDE BCDE BCDE AAAA AAAA BCDE BCDE BCDE BCDE
BCDE AAAA AAAA AAAA AAAA AAAA AAAA AAAA AAAA AAAA AAAA AAAA BCDE AAAA AAAA BCDE AAAA AAAA BCDE AAAA AAAA BCDE AAAA AAAA AAAA AAAA AAAA AAAA AAAA AAAA BCDE
BCDE AAAA AAAA BCDE BCDE BCDE BCDE BCDE BCDE BCDE AAAA AAAA BCDE AAAA AAAA BCDE AAAA AAAA BCDE AAAA AAAA BCDE BCDE BCDE BCDE BCDE BCDE BCDE AAAA AAAA BCDE
BCDE AAAA AAAA AAAA AAAA AAAA BCDE AAAA AAAA BCDE AAAA AAAA AAAA AAAA AAAA BCDE AAAA AAAA BCDE AAAA AAAA AAAA AAAA AAAA BCDE AAAA AAAA BCDE AAAA AAAA BCDE
BCDE BCDE BCDE BCDE AAAA AAAA BCDE AAAA AAAA BCDE BCDE BCDE BCDE AAAA AAAA BCDE AAAA AAAA BCDE BCDE BCDE BCDE AAAA AAAA BCDE AAAA AAAA BCDE BCDE BCDE BCDE
BCDE AAAA AAAA BCDE AAAA AAAA AAAA AAAA AAAA AAAA AAAA AAAA BCDE AAAA AAAA BCDE AAAA AAAA BCDE AAAA AAAA BCDE AAAA AAAA BCDE AAAA AAAA AAAA AAAA AAAA BCDE
BCDE AAAA AAAA BCDE AAAA AAAA BCDE BCDE BCDE BCDE AAAA AAAA BCDE BCDE BCDE BCDE AAAA AAAA BCDE AAAA AAAA BCDE AAAA AAAA BCDE AAAA AAAA BCDE BCDE BCDE BCDE
BCDE AAAA AAAA AAAA AAAA AAAA AAAA AAAA AAAA BCDE AAAA AAAA BCDE AAAA AAAA AAAA AAAA AAAA AAAA AAAA AAAA AAAA AAAA AAAA AAAA AAAA AAAA AAAA AAAA AAAA AAAA
BCDE BCDE BCDE BCDE BCDE BCDE BCDE BCDE BCDE BCDE BCDE BCDE BCDE BCDE BCDE BCDE BCDE BCDE BCDE BCDE BCDE BCDE BCDE BCDE BCDE BCDE BCDE BCDE AAAA AAAA AAAB