BCDE BCDE BCDE BCDE BCDE BCDE BCDE BCDE BCDE BCDE AAAA BCDE BCDE BCDE BCDE BCDE BCDE BCDE BCDE BCDE BCDE BCDE BCDE
BCDE AAAA AAAA AAAA AAAA AAAA AAAA AAAA AAAA AAAA AEAA AAAA AAAA AAAA AAAA AAAA AAAA AAAA AAAA AAAA AAAA AAAA BCDE
BCDE AAAA AAAA BBBB KBBB KBBB KBBB BBBB AAAA AAAA AEAA AAAA AAAA AAAA AAAA AAAA AAAA AAAA AAAA AAAA AAAA AAAA BCDE
BCDE AAAA AAAA BBBK AFBA AFBA AFBA BKBB AAAA AAAA AEAA AAAA AAAA AAAA AAAA AAAA AAAA AAAA AAAA AAAA AAAA AAAA BCDE
BCDE AAAA AAAA BBBK AFBA AFBA AFBA BKBB AAAA AAAA AEAA AAAA AAAA AAAA AAAA AAAA AAAA AAAA AAAA AAAA AAAA AAAA BCDE
BCDE AAAA AAAA BBBK AFBA AFBA AFBA BKBB AAAA AAAA AEAA AAAA AAAA AAAA AAAA AAAA AAAA AAAA AAAA AAAA AAAA AAAA BCDE
BCDE AAAA AAAA BBBB BBKB AEAA BBKB BBBB AAAA AAAA AEAA AAAA AAAA AAAA AAAA AAAA AAAA AAAA AAAA AAAA AAAA AAAA BCDE
BCDE AAAA AAAA AAAA AAAA AEAA AAAA AAAA AAAA AAAA AEAA AAAA AAAA AAAA AAAA AAAA AAAA AAAA AAAA AAAA AAAA AAAA BCDE
BCDE AAAA AAAA AAAA AAAA AEAA AAAA AAAA AAAA AAAA AEAA AAAA AAAA AAAA AAAA AAAA AAAA AAAA AAAA AAAA AAAA AAAA BCDE
BCDE AAAA AAAA AAAA AAAA AEAA AAAA AAAA AAAA AAAA AEAA AAAA AAAA AAAA AAAA AAAA AAAA AAAA AAAA AAAA AAAA AAAA BCDE
AGAA AGAA AGAA AGAA AGAA AFAA AGAA AGAA AGAA AGAA AFAB AGAA AGAA AGAA AGAA AGAA AGAA AGAA AGAA AGAA AGAA AGAA AAAA
BCDE AAAA AAAA AAAA AAAA AEAA AAAA AAAA AAAA AAAA AEAA AAAA AAAA AAAA AAAA AAAA AAAA AAAA AAAA AAAA AAAA AAAA BCDE
BCDE AAAA AAAA AAAA AAAA AEAA AAAA AAAA AAAA AAAA AEAA AAAA AAAA AAAA AAAA AAAA AAAA AAAA AAAA AAAA AAAA AAAA BCDE
BCDE AAAA AAAA AAAA AAAA AEAA AAAA AAAA AAAA AAAA AEAA AAAA AAAA AAAA CCCC CCCC CCCC AAAA AAAA AAAA AAAA AAAA BCDE
BCDE AAAA AAAA AAAA AAAA AEAA AAAA AAAA AAAA AAAA AEAA AAAA AAAA AAAA CCCC CCCC CCCC AAAA AAAA AAAA AAAA AAAA BCDE
BCDE AAAA AAAA AAAA AAAA AEAA AAAA AAAA AAAA AAAA AEAA AAAA AAAA AAAA CCCC CCCC CCCC AAAA AAAA AAAA AAAA AAAA BCDE
BCDE AAAA AAAA AAAA AAAA AEAA AAAA AAAA AAAA AAAA AEAA AAAA AAAA AAAA AAAA AAAA AAAA AAAA AAAA AAAA AAAA AAAA BCDE
BCDE AAAA AAAA AAAA AAAA AEAA AAAA AAAA AAAA AAAA AEAA AAAA AAAA AAAA AAAA AAAA AAAA AAAA AAAA AAAA AAAA AAAA BCDE
BCDE AAAA AAAA AAAA AAAA AEAA AAAA AAAA AAAA AAAA AEAA AAAA AAAA AAAA AAAA AAAA AAAA AAAA AAAA AAAA AAAA AAAA BCDE
BCDE AAAA AAAA AAAA AAAA AEAA AAAA AAAA AAAA AAAA AEAA AAAA AAAA AAAA AAAA AAAA AAAA AAAA AAAA AAAA AAAA AAAA BCDE
BCDE AAAA AAAA AAAA AAAA AEAA AAAA AAAA AAAA AAAA AEAA AAAA AAAA AAAA AAAA AAAA AAAA AAAA AAAA AAAA AAAA AAAA BCDE
BCDE BCDE BCDE BCDE BCDE BCDE BCDE BCDE BCDE BCDE AEAA BCDE BCDE BCDE BCDE BCDE BCDE BCDE BCDE BCDE BCDE BCDE BCDE