QQQQ QQQQ QQQQ QQQQ QQQQ QQQQ QQQQ QQQQ QQQQ QQQQ AEBB QQQQ QQQQ QQQQ QQQQ QQQQ QQQQ QQQQ QQQQ QQQQ QQQQ QQQQ QQQQ
QQQQ AAAA AAAA AAAA AAAA AAAB AAAA AAAA AAAA AAAA AEBA AAAA AAAA AAAA AAAA AAAA AAAA AAAA AAAA AAAA AAAA AAAB QQQQ
QQQQ AAAA AAAA BBBB KBBB KBBB KBBB BBBB AAAA AAAA AEBA AAAA AAAA AAAA AAAA AAAA AAAA AAAA AAAA AAAA AAAB AAAA QQQQ
QQQQ AAAA AAAA BBBK AFBB AFBB AFBB BKBB AAAA AAAA AEBA AAAA AAAA AAAA AAAA AAAA AAAA AAAA AAAA AAAA AAAA AAAB QQQQ
QQQQ AAAA AAAA BBBK AFBB AFBB AFBB BKBB AAAA AAAA AEBA AAAA AAAA AAAA AAAA AAAA AAAA AAAA AAAA AAAA AAAA AAAA QQQQ
QQQQ AAAA AAAA BBBK AFBB AFBB AFBB BKBB AAAA AAAA AEBA AAAA AAAA AAAA AAAA AAAA AAAA AAAA AAAA AAAA AAAA AAAA QQQQ
QQQQ AAAA AAAA BBBB BBKB TOOT BBKB BBBB AAAA AAAA AEBA AAAA AAAA AAAA AAAA AAAA AAAA AAAA AAAA AAAA AAAA AAAA QQQQ
QQQQ AAAA AAAA AAAA AAAA AEAA AAAA AAAA AAAA AAAA AEBA AAAA AAAA AAAA AAAA AAAA AAAA AAAA AAAA AAAA AAAA AAAA QQQQ
QQQQ AAAA AAAA AAAA AAAA AEAA AAAA AAAA ACCA ACCA AEBA ACCA ACCA AAAA AAAA AAAA AAAA AAAA AAAA AAAA AAAA AAAA QQQQ
QQQQ AAAA AAAA AAAA AAAA AEAA AAAA AAAA ACCA ALDD AFDA AMDD ACCA AAAA AAAA AAAA AAAA AAAA AAAA AAAA AAAA AAAA QQQQ
AGAB AGAA AGAA AGAA AGAA AFAC AGAA AGAA AGAE AFDA AFDB AFDA AGAA AGAA AGAA AGAA AGAA AGAA AGAA AMAA AAAA AAAA AAAB
QQQQ AAAA AAAA AAAA AAAA AEAA AAAA AAAA ACCA AODD AFDA ANDD ACCA AAAA AAAA AAAA AAAA AAAA AAAA AEAA AAAA AAAA QQQQ
QQQQ AAAA AAAA AAAA AAAA AEAA AAAA AAAA ACCA ACCA AEBA ACCA ACCA AAAA AAAA AAAA AAAA AAAA AAAA AEAA AAAA AAAA QQQQ
QQQQ AAAA AAAA AAAA AAAA AEAA AAAA AAAA AAAA AAAA AEBA AAAA AAAA AAAA CCCC CCCC CCCC AAAA AAAA AEAA AAAA AAAA QQQQ
QQQQ AAAA AAAA AAAA AAAA AEAA AAAA AAAA AAAA AAAA AEBA AAAA AAAA AAAA CCCC AAAB TCCC AAAA AAAA AEAA AAAA AAAA QQQQ
QQQQ AAAA AAAA AAAA AAAA AEAA AAAA AAAA AAAA AAAA AEBA AAAA AAAA AAAA CCCC CCCC CCCC AAAA AAAA AEAA AAAA AAAA QQQQ
QQQQ AAAA AAAA AAAA AAAA AEAA AAAA AAAA AAAA AAAA AEBA AAAA AAAA AAAA AAAA AAAA AAAA AAAA AAAA AEAA AAAA AAAA QQQQ
QQQQ AAAA AAAA AAAA AAAA AEAA AAAA AAAA AAAA AAAA AEBA AAAA AAAA AAAA AAAA AAAA AAAA AAAA AAAA AEAA AAAA AAAA QQQQ
QQQQ AAAB AAAA AAAA AAAA AOAA AGAA AGAA AGAA AGAA AFBA AGAA AGAA AGAA AGAA AGAA AGAA AGAA AGAA ANAA AAAA AAAA QQQQ
QQQQ AAAA AAAB AAAA AAAA AAAA AAAA AAAA AAAA AAAA AEBA AAAA AAAA AAAA AAAA AAAA AAAA AAAA AAAA AAAA AAAA AAAA QQQQ
QQQQ AAAB AAAA AAAA AAAA AAAA AAAA AAAA AAAA AAAA AEBA AAAA AAAA AAAA AAAA AAAA AAAA AAAA AAAA AAAA AAAA AAAA QQQQ
QQQQ QQQQ QQQQ QQQQ QQQQ QQQQ QQQQ QQQQ QQQQ QQQQ AEBB QQQQ QQQQ QQQQ QQQQ QQQQ QQQQ QQQQ QQQQ QQQQ QQQQ QQQQ QQQQ