OPQR OPQR OPQR OPQR OPQR OPQR OPQR OPQR OPQR OPQR OPQR OPQR OPQR OPQR OPQR OPQR
OPQR AAAA AAAA AAAA AAAA AAAA AAAA AAAA AAAA AAAA AAAA AAAA AAAA AAAA AAAA OPQR
OPQR AAAA AAAA AAAA AAAA AAAA AAAA AAAA AAAA AAAA AAAA AAAA AAAA AAAA AAAA OPQR
OPQR AAAA AAAA AAAA AAAA AAAA AAAA AAAA AAAA AAAA AAAA AAAA AAAA AAAA AAAA OPQR
OPQR AAAA AAAA AAAA AAAA AAAA AAAA AAAA AAAA OPQR OPQR OPQR OPQR AAAA AAAA OPQR
OPQR AAAA AAAA AAAA AAAA AAAA AAAA AAAA AAAA OPQR OPQR OPQR OPQR AAAA AAAA OPQR
OPQR AAAA AAAA AAAA AAAA AAAA AAAA AAAA AAAA OPQR OPQR OPQR OPQR AAAA AAAA OPQR
OPQR AAAA AAAA AAAA AAAA AAAA AAAA AAAA AAAA OPQR OPQR OPQR OPQR AAAA AAAA OPQR
OPQR AAAA AAAA AAAA AAAA AAAA AAAA AAAA AAAA AAAA AAAA AAAA AAAA AAAA AAAA OPQR
OPQR AAAA AAAA AAAA AAAA AAAA AAAA AAAA AAAA AAAA AAAA AAAA AAAA AAAA AAAA OPQR
OPQR AAAA AAAA AAAA AAAA AAAA AAAA AAAA AAAA AAAA AAAA AAAA AAAA AAAA AAAA OPQR
OPQR OPQR OPQR AAAA AAAA AAAA AAAA AAAA AAAA AAAA AAAA AAAA AAAA AAAA AAAA OPQR
OPQR OPQR OPQR AAAA AAAA AAAA AAAA AAAA AAAA AAAA AAAA AAAA AAAA AAAA AAAA OPQR
OPQR OPQR OPQR AAAA AAAA AAAA AAAA AAAA AAAA AAAA AAAA AAAA AAAA AAAA AAAA OPQR
OPQR OPQR OPQR OPQR OPQR OPQR OPQR OPQR OPQR OPQR OPQR OPQR OPQR OPQR OPQR OPQR