AAAB AAAA AAAA BCOR BCOR BCOR BCOR BCOR BCOR BCOR BCOR BCOR BCOR BCOR BCOR BCOR BCOR BCOR BCOR BCOR BCOR BCOR BCOR BCOR BCOR BCOR BCOR BCOR BCOR BCOR BCOR
AAAA AAAA AAAA BCOR AAAA AAAA AAAA AAAA AAAA BCOR AAAA AAAA BCOR AAAA AAAA AAAA AAAA AAAA BCOR AAAA AAAA AAAA AAAA AAAA BCOR AAAA AAAA AAAA AAAA AAAA BCOR
BCOR AAAA AAAA BCOR BCOR BCOR BCOR AAAA AAAA BCOR AAAA AAAA BCOR BCOR BCOR BCOR AAAA AAAA BCOR AAAA AAAA BCOR BCOR BCOR BCOR AAAA AAAA BCOR AAAA AAAA BCOR
BCOR AAAA AAAA AAAA AAAA AAAA BCOR AAAA AAAA AAAA AAAA AAAA BCOR AAAA AAAA BCOR AAAA AAAA AAAA AAAA AAAA BCOR AAAA AAAA AAAA AAAA AAAA BCOR AAAA AAAA BCOR
BCOR AAAA AAAA BCOR BCOR BCOR BCOR BCOR BCOR BCOR AAAA AAAA BCOR AAAA AAAA BCOR AAAA AAAA BCOR AAAA AAAA BCOR AAAA AAAA BCOR BCOR BCOR BCOR AAAA AAAA BCOR
BCOR AAAA AAAA AAAA AAAA AAAA AAAA AAAA AAAA AAAA AAAA AAAA BCOR AAAA AAAA BCOR AAAA AAAA BCOR AAAA AAAA AAAA AAAA AAAA BCOR AAAA AAAA AAAA AAAA AAAA BCOR
BCOR AAAA AAAA BCOR BCOR BCOR BCOR BCOR BCOR BCOR BCOR BCOR BCOR AAAA AAAA BCOR BCOR BCOR BCOR BCOR BCOR BCOR BCOR BCOR BCOR AAAA AAAA BCOR AAAA AAAA BCOR
BCOR AAAA AAAA AAAA AAAA AAAA AAAA AAAA AAAA AAAA AAAA AAAA AAAA AAAA AAAA BCOR AAAA AAAA AAAA AAAA AAAA BCOR AAAA AAAA BCOR AAAA AAAA BCOR AAAA AAAA BCOR
BCOR AAAA AAAA BCOR BCOR BCOR BCOR AAAA AAAA BCOR BCOR BCOR BCOR AAAA AAAA BCOR AAAA AAAA BCOR BCOR BCOR BCOR AAAA AAAA BCOR AAAA AAAA BCOR BCOR BCOR BCOR
BCOR AAAA AAAA BCOR AAAA AAAA AAAA AAAA AAAA BCOR AAAA AAAA AAAA AFAA AFAA AFAA AAAA AAAA AAAA AAAA AAAA BCOR AAAA AAAA AAAA AAAA AAAA AAAA AAAA AAAA BCOR
BCOR AAAA AAAA BCOR BCOR BCOR BCOR BCOR BCOR BCOR BCOR BCOR BCOR AFAA AFAA AFAA BCOR BCOR BCOR AAAA AAAA BCOR AAAA AAAA BCOR BCOR BCOR BCOR AAAA AAAA BCOR
BCOR AAAA AAAA BCOR AAAA AAAA BCOR AAAA AAAA AAAA AAAA AAAA AAAA AFAA AFAA AFAA AAAA AAAA BCOR AAAA AAAA AAAA AAAA AAAA AAAA AAAA AAAA BCOR AAAA AAAA BCOR
BCOR BCOR BCOR BCOR AAAA AAAA BCOR BCOR BCOR BCOR AAAA AAAA BCOR BCOR BCOR BCOR AAAA AAAA BCOR BCOR BCOR BCOR BCOR BCOR BCOR AAAA AAAA BCOR BCOR BCOR BCOR
BCOR AAAA AAAA AAAA AAAA AAAA AAAA AAAA AAAA AAAA AAAA AAAA BCOR AAAA AAAA BCOR AAAA AAAA BCOR AAAA AAAA BCOR AAAA AAAA AAAA AAAA AAAA AAAA AAAA AAAA BCOR
BCOR AAAA AAAA BCOR BCOR BCOR BCOR BCOR BCOR BCOR AAAA AAAA BCOR AAAA AAAA BCOR AAAA AAAA BCOR AAAA AAAA BCOR BCOR BCOR BCOR BCOR BCOR BCOR AAAA AAAA BCOR
BCOR AAAA AAAA AAAA AAAA AAAA BCOR AAAA AAAA BCOR AAAA AAAA AAAA AAAA AAAA BCOR AAAA AAAA BCOR AAAA AAAA AAAA AAAA AAAA BCOR AAAA AAAA BCOR AAAA AAAA BCOR
BCOR BCOR BCOR BCOR AAAA AAAA BCOR AAAA AAAA BCOR BCOR BCOR BCOR AAAA AAAA BCOR AAAA AAAA BCOR BCOR BCOR BCOR AAAA AAAA BCOR AAAA AAAA BCOR BCOR BCOR BCOR
BCOR AAAA AAAA BCOR AAAA AAAA AAAA AAAA AAAA AAAA AAAA AAAA BCOR AAAA AAAA BCOR AAAA AAAA BCOR AAAA AAAA BCOR AAAA AAAA BCOR AAAA AAAA AAAA AAAA AAAA BCOR
BCOR AAAA AAAA BCOR AAAA AAAA BCOR BCOR BCOR BCOR AAAA AAAA BCOR BCOR BCOR BCOR AAAA AAAA BCOR AAAA AAAA BCOR AAAA AAAA BCOR AAAA AAAA BCOR BCOR BCOR BCOR
BCOR AAAA AAAA AAAA AAAA AAAA AAAA AAAA AAAA BCOR AAAA AAAA BCOR AAAA AAAA AAAA AAAA AAAA AAAA AAAA AAAA AAAA AAAA AAAA AAAA AAAA AAAA AAAA AAAA AAAA AAAA
BCOR BCOR BCOR BCOR BCOR BCOR BCOR BCOR BCOR BCOR BCOR BCOR BCOR BCOR BCOR BCOR BCOR BCOR BCOR BCOR BCOR BCOR BCOR BCOR BCOR BCOR BCOR BCOR AAAA AAAA AAAB