1234 1234 1234 1234 1234 1234 1234 1234 1234 1234 1234 1234 1234 1234 1234 1234 1234 1234 1234 1234
1234 0000 0000 0000 0000 0000 0000 0000 0000 0000 0000 0000 0000 0000 0000 0000 0000 0000 0000 1234
1234 0000 0000 1111 1111 1111 1111 1111 0000 0000 0000 0000 0000 0000 0000 0000 0000 0000 0000 1234
1234 0000 0000 1111 0000 0000 0000 1111 0000 0000 0000 0000 0000 0000 0000 0000 0000 0000 0000 1234
1234 0000 0000 1111 0000 0000 0000 1111 0000 0000 0000 0000 0000 0000 0000 0000 0000 0000 0000 1234
1234 0000 0000 1111 0000 0000 0000 1111 0000 0000 0000 0000 0000 0000 0000 0000 0000 0000 0000 1234
1234 0000 0000 1111 1111 0000 1111 1111 0000 0000 0000 0000 0000 0000 0000 0000 0000 0000 0000 1234
1234 0000 0000 0000 0000 0000 0000 0000 0000 0000 0000 0000 0000 0000 0000 0000 0000 0000 0000 1234
1234 0000 0000 0000 0000 0000 0000 0000 0000 0000 0000 0000 0000 0000 0000 0000 0000 0000 0000 1234
1234 0000 0000 0000 0000 0000 0000 0000 0000 0000 0000 0000 0000 0000 0000 0000 0000 0000 0000 1234
1234 0000 0000 0000 0000 0000 0000 0000 0000 0000 0000 0000 0000 0000 0000 0000 0000 0000 0000 1234
1234 0000 0000 0000 0000 0000 0000 0000 0000 0000 0000 0000 0000 0000 0000 0000 0000 0000 0000 1234
1234 0000 0000 0000 0000 0000 0000 0000 0000 0000 0000 0000 0000 0000 0000 0000 0000 0000 0000 1234
1234 0000 0000 0000 0000 0000 0000 0000 0000 0000 1234 0000 0000 0000 2222 2222 2222 0000 0000 1234
1234 0000 0000 0000 0000 0000 0000 0000 0000 0000 0000 0000 0000 0000 2222 2222 2222 0000 0000 1234
1234 0000 0000 0000 0000 0000 0000 0000 0000 0000 0000 0000 0000 0000 2222 2222 2222 0000 0000 1234
1234 0000 0000 0000 0000 0000 0000 0000 0000 0000 0000 0000 0000 0000 0000 0000 0000 0000 0000 1234
1234 0000 0000 0000 0000 0000 0000 0000 0000 0000 0000 0000 0000 0000 0000 0000 0000 0000 0000 1234
1234 0000 0000 0000 0000 0000 0000 0000 0000 0000 0000 0000 0000 0000 0000 0000 0000 0000 0000 1234
1234 1234 1234 1234 1234 1234 1234 1234 1234 1234 1234 1234 1234 1234 1234 1234 1234 1234 1234 1234