QQQQ QQQQ QQQQ QQQQ QQQQ QQQQ QQQQ QQQQ QQQQ QQQQ QQQQ QQQQ QQQQ QQQQ QQQQ QQQQ QQQQ QQQQ QQQQ QQQQ QQQQ QQQQ QQQQ QQQQ
QQQQ AAAA AAAA AAAA AAAA AAAA AAAA AAAA AAAA AAAA QQQQ AAAA AAAA AAAA QQQQ AAAA AAAA AAAA AAAA AAAA AAAA AAAA AAAA QQQQ
QQQQ AAAA AAAA AAAA AAAA AAAA AAAA AAAA AAAA AAAA TQQQ AGAA AMAA AAAA QQQQ AAAA AAAA AAAA AAAA AAAA AAAA AAAA AAAA QQQQ
QQQQ AAAA AAAA AAAA AAAA AAAA AAAA AAAA AAAA AAAA QQQQ AAAA AEAA AAAA QQQQ AAAA AAAA AAAA AAAA AAAA AAAA AAAA AAAA QQQQ
QQQQ AAAA AAAA AAAA AAAA AAAA AAAA AAAA AAAA AAAA QQQQ AAAA AEAA AAAA QQQQ AAAA AAAA AAAA AAAA AAAA AAAA AAAA AAAA QQQQ
QQQQ AAAA AAAA AAAA AAAA AAAA AAAA AAAA AAAA AAAA QQQQ AAAA AEAA AAAA QQQQ AAAA AAAA AAAA AAAA AAAA AAAA AAAA AAAA QQQQ
QQQQ AAAA AAAA AAAA AAAA QQQQ QQQQ QQQQ QQQQ QQQQ QQQQ ALAA AFAA AMAA SQQQ SQQQ SQQQ SQQQ SQQQ SQQQ SQQQ SQQQ TAAA QSQQ
QQQQ AAAA AAAA AAAA AAAA AFAA AFAA AFAA AFAA AFAA AFAA AFAA AFAA AFAA AFAA AFAA AFAA AFAA AFAA AFAA AFAA AFAA AFAA QRQQ
QQQQ AAAA AAAA AAAA AAAA AFAA ALAA AMAA AFAA ALAA AMAA AFAA AFAA AFAA ALAA AMAA AFAA AFAA ALAA AMAA AFAA AFAA AFAA QRQQ
QQQQ AAAA AAAA AAAA AAAA AFAA AOAA ANAA AFAA AOAA ANAA AFAA AFAA AFAA AOAA ANAA AFAA AFAA AOAA ANAA AFAA AFAA AFAA QRQQ
QQQQ AAAA AAAA AAAA AAAA AFAA AFAA AFAA AFAA AFAA AFAA AFAA AFAA AFAA AFAA AFAA AFAA AFAA AFAA AFAA AFAA AFAA AFAA QRQQ
QQQQ AAAA AAAA AAAA AAAA QQQQ QQQQ QQQQ QQQQ QQQQ QQQQ AOAA AFAA ANAA QQSQ QQSQ QQSQ QQSQ QQSQ QQSQ QQSQ QQSQ TAAA QSQQ
QQQQ AAAA AAAA AAAA AAAA AAAA AAAA AAAA AAAA AAAA QQQQ AAAA AEAA AAAA QQQQ QQQQ QQQQ QQQQ QQQQ QQQQ AAAA AAAA AAAA QQQQ
QQQQ AAAA AAAA AAAA AAAA AAAA AAAA AAAA AAAA AAAA QQQQ AAAA AEAA AAAA AAAA AAAA AAAA AAAA AAAA QQQQ AAAA AAAA AAAA QQQQ
QQQQ AAAA AAAA AAAA AAAA AAAA AAAA AAAA AAAA AAAA QQQQ AAAA AEAA AAAA AAAA AAAA AAAA AAAA AAAA QQQQ AAAA AAAA AAAA QQQQ
QQQQ AAAA AAAA AAAA AAAA AAAA AAAA AAAA AAAA AAAA QQQQ AAAA AEAA AAAA AAAA AAAA AAAA AAAA AAAA QQQQ AAAA AAAA AAAA QQQQ
QQQQ AAAA AAAA AAAA AAAA AAAA AAAA AAAA AAAA AAAA QQQQ AAAA AOAA AGAA AGAA AGAA AGAA AGAA AGAA TQQQ AAAA AAAA AAAA QQQQ
QQQQ AAAA AAAA AAAA AAAA AAAA AAAA AAAA AAAA AAAA QQQQ AAAA AAAA AAAA AAAA AAAA AAAA AAAA AAAA QQQQ AAAA AAAA AAAA QQQQ
QQQQ AAAA AAAA AAAA AAAA AAAA AAAA AAAA AAAA AAAA QQQQ AAAA AAAA AAAA AAAA AAAA AAAA AAAA AAAA QQQQ AAAA AAAA AAAA QQQQ
QQQQ AAAA AAAA AAAA AAAA AAAA AAAA AAAA AAAA AAAA QQQQ AAAA AAAA AAAA AAAA AAAA AAAA AAAA AAAA QQQQ AAAA AAAA AAAA QQQQ
QQQQ QQQQ QQQQ QQQQ QQQQ QQQQ QQQQ QQQQ QQQQ QQQQ QQQQ QQQQ QQQQ QQQQ QQQQ QQQQ QQQQ QQQQ QQQQ QQQQ QQQQ QQQQ QQQQ QQQQ