PRST PRST PRST PRST PRST PRST PRST PRST PRST PRST PRST PRST PRST PRST PRST PRST
PRST AAAA AAAA AAAA AAAA AAAA AAAA AAAA AAAA AAAA AAAA AAAA AAAA AAAA AAAA PRST
PRST AAAA AAAA AAAA AAAA AAAA AAAA AAAA AAAA AAAA AAAA AAAA AAAA AAAA AAAA PRST
PRST AAAA AAAA AAAA AAAA AAAA AAAA AAAA AAAA AAAA AAAA AAAA AAAA AAAA AAAA PRST
PRST AAAA AAAA AAAA AAAA AAAA AAAA AAAA AAAA PRST PRST PRST PRST AAAA AAAA PRST
PRST AAAA AAAA AAAA AAAA AAAA AAAA AAAA AAAA PRST PRST PRST PRST AAAA AAAA PRST
PRST AAAA AAAA AAAA AAAA AAAA AAAA AAAA AAAA PRST PRST PRST PRST AAAA AAAA PRST
PRST AAAA AAAA AAAA AAAA AAAA AAAA AAAA AAAA PRST PRST PRST PRST AAAA AAAA PRST
PRST AAAA AAAA AAAA AAAA AAAA AAAA AAAA AAAA AAAA AAAA AAAA AAAA AAAA AAAA PRST
PRST AAAA AAAA AAAA AAAA AAAA AAAA AAAA AAAA AAAA AAAA AAAA AAAA AAAA AAAA PRST
PRST AAAA AAAA AAAA AAAA AAAA AAAA AAAA AAAA AAAA AAAA AAAA AAAA AAAA AAAA PRST
PRST PRST PRST AAAA AAAA AAAA AAAA AAAA AAAA AAAA AAAA AAAA AAAA AAAA AAAA PRST
PRST PRST PRST AAAA AAAA AAAA AAAA AAAA AAAA AAAA AAAA AAAA AAAA AAAA AAAA PRST
PRST PRST PRST AAAA AAAA AAAA AAAA AAAA AAAA AAAA AAAA AAAA AAAA AAAA AAAA PRST
PRST PRST PRST PRST PRST PRST PRST PRST PRST PRST PRST PRST PRST PRST PRST PRST