SBBA SAAA SBBB SSSS SBBA
SSSS AAAA ABBA AAAA SAAA
SBBB ABBA AAAA ABBA SBBB
SAAA AAAA ABBA AAAA SSSS
SBBA SSSS SBBB SAAA SBBA