BCDE BCDE BCDE BCDE BCDE BCDE BCDE BCDE BCDE BCDE AAAB BCDE BCDE BCDE BCDE BCDE BCDE BCDE BCDE BCDE BCDE BCDE BCDE
BCDE AAAB AAAA AAAA AAAA AAAA AAAA AAAA AAAA AAAA AEAA AAAA AAAA AAAA AAAA AAAA AAAA AAAA AAAA AAAA AAAA AAAB BCDE
BCDE AAAA AAAA BBBB KBBB KBBB KBBB BBBB AAAA AAAA AEAA AAAA AAAA AAAA AAAA AAAA AAAA AAAA AAAA AAAA AAAB AAAA BCDE
BCDE AAAA AAAA BBBK AFBA AFBA AFBA BKBB AAAA AAAA AEAA AAAA AAAA AAAA AAAA AAAA AAAA AAAA AAAA AAAA AAAA AAAB BCDE
BCDE AAAA AAAA BBBK AFBA AFBA AFBA BKBB AAAA AAAA AEAA AAAA AAAA AAAA AAAA AAAA AAAA AAAA AAAA AAAA AAAA AAAA BCDE
BCDE AAAA AAAA BBBK AFBA AFBA AFBA BKBB AAAA AAAA AEAA AAAA AAAA AAAA AAAA AAAA AAAA AAAA AAAA AAAA AAAA AAAA BCDE
BCDE AAAA AAAA BBBB BBKB POOP BBKB BBBB AAAA AAAA AEAA AAAA AAAA AAAA AAAA AAAA AAAA AAAA AAAA AAAA AAAA AAAA BCDE
BCDE AAAA AAAA AAAA AAAA AEAA AAAA AAAA AAAA AAAA AEAA AAAA AAAA AAAA AAAA AAAA AAAA AAAA AAAA AAAA AAAA AAAA BCDE
BCDE AAAA AAAA AAAA AAAA AEAA AAAA AAAA AAAA AAAA AEAA AAAA AAAA AAAA AAAA AAAA AAAA AAAA AAAA AAAA AAAA AAAA BCDE
BCDE AAAA AAAA AAAA AAAA AEAA AAAA AAAA AAAA AAAA AEAA AAAA AAAA AAAA AAAA AAAA AAAA AAAA AAAA AAAA AAAA AAAA BCDE
AGAB AGAA AGAA AGAA AGAA AFAC AGAA AGAD AGAE AGAA AFAB AGAA AGAA AGAA AGAA AGAA AGAA AGAA AGAA AGAA AGAA AGAA AAAB
BCDE AAAA AAAA AAAA AAAA AEAA AAAA AAAA AAAA AAAA AEAA AAAA AAAA AAAA AAAA AAAA AAAA AAAA AAAA AAAA AAAA AAAA BCDE
BCDE AAAA AAAA AAAA AAAA AEAA AAAA AAAA AAAA AAAA AEAA AAAA AAAA AAAA AAAA AAAA AAAA AAAA AAAA AAAA AAAA AAAA BCDE
BCDE AAAA AAAA AAAA AAAA AEAA AAAA AAAA AAAA AAAA AEAA AAAA AAAA AAAA CCCC CCCC CCCC AAAA AAAA AAAA AAAA AAAA BCDE
BCDE AAAA AAAA AAAA AAAA AEAA AAAA AAAA AAAA AAAA AEAA AAAA AAAA AAAA CCCC CCCC CCCC AAAA AAAA AAAA AAAA AAAA BCDE
BCDE AAAA AAAA AAAA AAAA AEAA AAAA AAAA AAAA AAAA AEAA AAAA AAAA AAAA CCCC CCCC CCCC AAAA AAAA AAAA AAAA AAAA BCDE
BCDE AAAA AAAA AAAA AAAA AEAA AAAA AAAA AAAA AAAA AEAA AAAA AAAA AAAA AAAA AAAA AAAA AAAA AAAA AAAA AAAA AAAA BCDE
BCDE AAAA AAAA AAAA AAAA AEAA AAAA AAAA AAAA AAAA AEAA AAAA AAAA AAAA AAAA AAAA AAAA AAAA AAAA AAAA AAAA AAAA BCDE
BCDE AAAB AAAA AAAA AAAA AEAA AAAA AAAA AAAA AAAA AEAA AAAA AAAA AAAA AAAA AAAA AAAA AAAA AAAA AAAA AAAA AAAA BCDE
BCDE AAAA AAAB AAAA AAAA AEAA AAAA AAAA AAAA AAAA AEAA AAAA AAAA AAAA AAAA AAAA AAAA AAAA AAAA AAAA AAAA AAAA BCDE
BCDE AAAB AAAA AAAA AAAA AEAA AAAA AAAA AAAA AAAA AEAA AAAA AAAA AAAA AAAA AAAA AAAA AAAA AAAA AAAA AAAA AAAA BCDE
BCDE BCDE BCDE BCDE BCDE BCDE BCDE BCDE BCDE BCDE AEAB BCDE BCDE BCDE BCDE BCDE BCDE BCDE BCDE BCDE BCDE BCDE BCDE